0112222222222110
1000200000021101
1000200000020001
1000000000000001
1000000000000001
1000000000020001
1000000000020001
1000200000000001
1000200000000001
1000200020000001
1000000020000001
1000000020000001
1000200020000001
0111111111111110
 
