1111111111111111
1200020000200021
1000020000200001
1000020000000001
1000020000000001
1000020000200001
1000020000000001
1000020000000001
1000020000200001
1000020000200001
1000000000200001
1000000000200001
1200000000200021
1111111111111111
 
