2222222222222222
2220000000000002
2220000000000002
2222000000000001
1111000000000001
1111111111110011
1000000000000001
1000000000000001
1111001111111111
1111000000011111
1111000000111111
1000000000111111
1000000111111111
1111111111111111
    
